.........
.........
.........
.........
.........
..b......
..b.c..d.
..ae.....
.........